******++++/-
*+///----*/*
*+++/-++**+*
**+-/**++*+*
+*---*--+*+*
+++-**-///+*
+/////--//**
+-///****+**
+---/*//++//
++-*/++//+//
++***+**/+*/
+++*++*---*/
+-----**--//